// テストステージ

// 00 ~ 49 がマップオブジェクト(０は空)
// 当たり判定があるのは１のみ
// mapWidth mapHeight gridSize は
// 絶対に記述すること（面倒とか言わない）

// 100 ~ がアクター -100した値がアクターのnoとなる
// アクターの番号のオプションはactorかstartと記述
// start記述のアクターは操作の対象になる。

001,001,001,001,001,001,001,001,001,001,001,001,001,001,001,001,001,001,001,001,001,001,001,001,001,001,001,001,001,001,001,001,001,001,001,001,001,001,001,001,001,001,001,001,
001,001,001,001,001,001,001,001,001,001,001,001,001,001,001,001,001,001,001,001,001,001,001,001,001,001,001,001,001,001,001,001,001,001,001,001,001,001,001,001,001,001,001,001,
001,001,000,000,000,000,000,000,000,000,000,000,000,000,001,001,000,000,000,000,000,000,000,000,000,000,000,000,000,000,000,000,000,000,000,000,000,000,000,000,000,000,001,001,
001,001,000,000,000,000,000,000,000,000,000,000,000,000,001,001,000,000,000,000,000,000,000,000,000,000,000,000,000,000,000,000,000,000,000,000,000,000,000,000,000,000,001,001,
001,001,000,000,000,000,000,000,000,000,000,000,000,000,001,001,000,000,000,000,000,000,000,000,000,000,000,000,000,000,000,000,000,000,000,000,000,000,000,000,000,000,001,001,
001,001,000,000,000,000,000,000,000,000,000,000,000,000,001,001,000,000,000,000,000,000,000,000,000,000,000,000,000,000,000,000,000,000,000,000,000,000,000,000,000,000,001,001,
001,001,000,000,000,000,000,000,000,000,000,000,000,000,001,001,000,000,101,000,000,101,000,000,000,000,000,000,9000,000,9100,000,9200,000,9100,000,9300,000,9400,000,000,000,001,001,
001,001,000,000,000,000,000,000,000,101,000,000,000,000,001,001,000,000,000,000,000,000,000,000,000,000,000,000,000,000,000,000,000,000,000,000,000,000,000,000,000,000,001,001,
001,001,000,000,000,000,000,000,000,000,000,000,000,000,000,000,000,000,000,000,000,000,000,000,000,000,000,000,000,000,000,000,000,000,000,000,000,000,000,000,000,000,001,001,
001,001,000,999,000,000,000,000,000,000,000,001,000,000,000,000,000,000,000,000,001,000,000,000,000,000,000,000,000,000,000,000,000,000,000,000,000,000,000,000,000,000,001,001,
001,001,000,000,000,000,000,000,000,000,001,001,000,000,000,000,000,000,000,000,001,001,000,000,000,000,000,000,000,000,000,000,000,000,000,000,000,000,000,000,000,000,001,001,
001,001,000,997,000,000,000,000,000,001,001,001,000,000,006,000,000,006,102,000,001,001,001,000,002,000,000,000,000,003,000,000,000,000,004,000,000,000,000,000,998,000,001,001,
001,001,001,001,001,001,001,001,001,001,001,001,001,001,001,001,001,001,001,001,001,001,001,001,001,001,001,001,001,001,001,001,001,001,001,001,001,001,001,001,001,001,001,001,
001,001,001,001,001,001,001,001,001,001,001,001,001,001,001,001,001,001,001,001,001,001,001,001,001,001,001,001,001,001,001,001,001,001,001,001,001,001,001,001,001,001,001,001,


// マップチップ
#1	image/obj/ground_labo.png
#2	image/obj/machine0.png
#3	image/obj/machine1.png
#4	image/obj/machine2.png
#5	image/obj/machine3.png
#6	image/obj/machine4.png
qq
// アクターセット
#999	start
#101	actor
#102	actor
#103	actor
#104	actor
#105	actor
#106	actor
#109	actor
#140	actor
#9000	actor
#9100	actor
#9200	actor
#9300	actor
#9400	actor

//	ワープ
#997	warp/3
#998	warp/1


// 定数
@mapWidth	44
@mapHeight	14
@gridSize	9
